┌──────────────────────────────────────────────────────────┐
│                                                          │
│                                                          │
│                                                          │
│    ┌──────┐                                              │
│    │      │                                              │
│    │      │                                              │
│    │      │             ┌───────────────────┐            │
│    │      └─────────────┘                   │            │
│    │                                        │            │
│    │      ┌─────────────┐                   │            │
│    │      │             │                   │            │
│    └──────┘             │                   │            │
│                         │  ┌──────┐  ┌──────┘            │
│                         │  │      │  │                   │
│                         │  │      │  │                   │
│             ┌───────────┘  │      │  │                   │
│             │              │      │  │                   │
│             │              │   ┌──┘  └─────────────┐     │
│             │              │   │                   │     │
│ ┌──────┐    │              │   │         ┌──────┐  │     │
│ │      │    │              │   │         │      │  │     │
│ │      └────┘              │   │         │      │  │     │
│ │                          │   │         │      │  │     │
│ │      ┌────┐              │   └─────────┘      │  │     │
│ └──────┘    └┬   ───────   ┤                  ┌─┘  └─┐   │
│              │             │                  │      │   │
│              │             │                  │      │   │
│              │             │                  │      │   │
│              └─────────────┘                  │      │   │
│                                               └──────┘   │
│                                                          │
│                                                          │
│                                                          │
└──────────────────────────────────────────────────────────┘