┌────────────────────────────────────────────────────────────┐
│                                                            │
│    ┌────────┐                                              │
│    │        │                                              │
│    │        │                                              │
│    │        │   ┌────────┐            ┌──────────────┐     │
│  ┌─┴──    ──┴─┐ │        │            │              │     │
│  │            │ │        │            │              │     │
│  │            │ │        │            │              │     │
│  │            └─┘        │            │              │     │
│  │                       ├────────┐   │              │     │
│  │            ┌─┐        │        │   └───┐  ┌───────┘     │
│  │            │ │                 │       │  │             │
│  └────────────┘ └────────┐        │   ┌───┘  └───────────┐ │
│                          │        │   │                  │ │
│                   ┌────┐ │        └───┘                  │ │
│  ┌────────────┐   │    │ │                               │ │
│  │            └───┘    │ │        ┌───┐                  │ │
│  │                     │ └──┐   ┌─┘   └───────┐ ┌────────┘ │
│  │            ┌───┐    │    ├   ┤             │ │          │
│  │            │   │    │ ┌──┘   └──┐ ┌──────┐ │ │ ┌──────┐ │
│  │            │   └─┐ ┌┘ │         │ │      │ │ │ │      │ │
│  └─┬───  ───┬─┘     │ │  │         │ │      │ │ │ │      │ │
│    │        │       │ └──┘         │ │      └─┘ │ │      │ │
│    │        │       │              │ │          │ │      │ │
│    │        │       └────┐         │ │      ┌─┐ └─┘      │ │
│    │        │            │         │ │      │ │          │ │
│    │        │ ┌──────────┴───   ───┤ └──────┘ │ ┌────────┘ │
│    └─┐   ┌──┘ │                    │          │ │          │
│      ├─ ─┤    │                    ├──────────┘ │ ┌──────┐ │
│      │   │    │                                 └─┘      │ │
│      │ X │    │                    ├──────────┐          │ │
│      └───┘    └────────────────────┘          └──────────┘ │
│                                                            │
└────────────────────────────────────────────────────────────┘