┌────────────────────────────────────────────────────────────┐
│                                                            │
│    ┌────────┐                                              │
│    │        │                                              │
│    │        │                                              │
│    │        │   ┌────────┐            ┌──────────────┐     │
│  ┌─┴──    ──┴─┐ │    !   │            │              │     │
│  │            │ │        │            │              │     │
│  │            │ │        │            │              │     │
│  │            └─┘        │            │          !   │     │
│  │     !                 ├────────┐   │              │     │
│  │            ┌─┐        │        │   └───┐  ┌───────┘     │
│  │            │ │                 │       │  │             │
│  └────────────┘ └────────┐        │   ┌───┘  └───────────┐ │
│                          │   !    │   │                  │ │
│                   ┌────┐ │        └───┘                  │ │
│  ┌────────────┐   │    │ │                               │ │
│  │            └───┘    │ │        ┌───┐                  │ │
│  │                     │ └──┐   ┌─┘   └───────┐ ┌────────┘ │
│  │    !       ┌───┐    │    ├   ┤             │ │          │
│  │            │   │    │ ┌──┘   └──┐ ┌──────┐ │ │ ┌──────┐ │
│  │            │   └─┐ ┌┘ │         │ │      │ │ │ │      │ │
│  └─┬───  ───┬─┘     │ │  │         │ │      │ │ │ │  !   │ │
│    │        │       │ └──┘         │ │      └─┘ │ │      │ │
│    │        │       │              │ │          │ │      │ │
│    │        │       └────┐         │ │      ┌─┐ └─┘      │ │
│    │        │            │         │ │      │ │          │ │
│    │        │ ┌──────────┴───   ───┤ └──────┘ │ ┌────────┘ │
│    └─┐   ┌──┘ │                    │          │ │          │
│      ├─ ─┤    │                    ├──────────┘ │ ┌──────┐ │
│      │   │    │        !                        └─┘  !   │ │
│      │ X │    │                    ├──────────┐          │ │
│      └───┘    └────────────────────┘          └──────────┘ │
│                                                            │
└────────────────────────────────────────────────────────────┘