┌────────────────────────────────────────────────────────────┐
│                                                            │
│  ┌──────────────────┐                 ┌──┐      ┌───────┐  │
│  │                  └─────────────────┘  └──────┘       │  │
│  │                                                      │  │
│  │                  ┌─────────────────┐  ┌──────┐       │  │
│  │                  │                 │  │      └───────┘  │
│  └────┬──   ──┬─────┘                 │  │                 │
│       │       │                       │  └┬──────────────┐ │
│       │       │ ┌──────────┐          │   │              │ │
│       │       │ │          │          │   │              │ │
│       │       │ │          │          │                  │ │
│       │       └─┘          │          │                  │ │
│       │                ────┴───────┐  │                  │ │
│       │       ┌─┐                  │  │   │              │ │
│       │       │ │                  │  │   │              │ │
│       │       │ └──────┬────       └──┘  ┌┴──────────────┘ │
│       │       │        │                 │                 │
│       │       │        │           ┌──┐  │                 │
│       └────┐  │        │           │  │  │                 │
│            │  │        └───────────┘  │  │                 │
│   ┌──────┐ │  │                       │  │                 │
│   │      │ │  │                     ┌─┘  └───┐             │
│   │      │ │  │                     │        │             │
│   │     ┌┴─┘  └─────────────────────┘        │             │
│   │     │                                    │             │
│   │                   ┌────┐ ┌───────────────┘             │
│   │     │             │    │ │                             │
│   │     └┬────────────┘  ┌─┘ └──┐                          │
│   │      │               │      │                          │
│   │      │               │      │                          │
│   └──────┘               │      │                          │
│                          └──────┘                          │
│                                                            │
└────────────────────────────────────────────────────────────┘